S.#####
#..#..#
##...##
#..#..#
#..##.#
#.#...#
#####.E

