S.###############################################################################
....#.#...#...........#.................#.#.......#.........#.....#.#.....#.....#
###.#.###.#.#.#####.###.###.###.#######.#.###.#####.#.###.#######.#.#.#.###.#.###
#.#.#.#.....#.#.....#.#.#.#.#...#...................#...#.#.......#.#.#.....#...#
#.#.#.#.###.#####.#.#.#.#.#.#########.#.#.###.###.###.#####.#######.#.#####.#####
#...#.....#.#.#...#.......#...#...#...#.#...#.#.#...#...#.#.#...#.#.......#...#.#
#.#####.###.#.###.###########.###.###.###.###.#.#.#.###.#.#.#.###.#.###.#.#####.#
#...#.#.#.#.#.#.......#.#.#.......#...#...#.....#.#.#.......#.....#.#...#.#.#...#
#.###.#.#.###.#.#.#####.#.#.#######.###########.#####.#.#.#######.###.#.###.###.#
#...#.....#...#.#.#.....#.#.....#.#.#...#.........#...#.#...#.......#.#.......#.#
#.###.#.#####.#.#.###.#.#.###.###.###.#############.#.#.#.###.#.#####.#####.###.#
#...#.#.....#...#.....#.....#.#.........#...#.#.....#.#.#...#.#.#...#.....#.....#
###.###.###########.###.#######.#.#######.###.#######.#####.###.#.#.#.###########
#...#...#...#.....#.#.#.....#...#...#.....#.#.......#.#.#...#.#.#.#.#...#.#.....#
###.###.###.###.#.###.#.#.#########.#.#####.###.#.#.#.#.###.#.#.###.#.#.#.#.#####
#.#.......#...#.#.#...#.#.......#.....#...#.#...#.#.......#.#.........#.....#.#.#
#.###.#######.#.#.###.###.#.#########.#.###.###.#.#######.###.#####.#####.###.#.#
#.......#.#...#.#.....#...#...#.#.#...#.#...#...#.#.#.......#.....#.....#.....#.#
#.#######.###.#######.#########.#.#.###.#.###.#.###.#.#.###########.###########.#
#.#.....#...#.........#.#...#...#.#.....#.#...#.#.#.#.#.#.#.............#.#.....#
#####.#####.#######.###.#.#.#.###.#.###.#.#.#.###.#.###.#.###.###.#######.#.#####
#.....#.......#...#.....#.#.....#.#...#.#...#...#...#...........#...............#
#.#########.#.#.#####.#.###.#.#.#.#.#######.###.#.#.###.###.#.#.#.#########.###.#
#...#.#...#.#...#...#.#.#...#.#.........#.#...#.#.#.#...#.#.#.#.#.#.....#...#...#
###.#.#.#.#.#######.###.#.#############.#.#####.#.#####.#.#.#####.#.###.#.#######
#.#.#.#.#...#...#...#.#.........#.#.#.........#...#.....#...#.......#.#.#.......#
#.#.#.#.###.#.###.#.#.#.#####.#.#.#.###.#######.###.#.###.#.###.#.###.#.#########
#.......#.........#.......#...#...#.#.............#.#.#...#...#.#.....#.........#
#####.###.#.#.#.#.#.###.#####.#####.###.###.#######.#.#############.#####.#.###.#
#...#.#...#.#.#.#.#.#.....#.......#.#.#.#.#.#.#...#.#.#.#.......#...#.#...#.#...#
###.###.###.###.#.###.#.#.#.#######.#.#.#.#.#.#.#.#.###.###.#####.#.#.#.#.#.#####
#.....#...#...#.#.#.#.#.#.#.....#...#.....#.#...#...........#.#...#.#.#.#.#...#.#
#.#####.#######.###.#.#.###.#####.#########.#.###.#.###.#.###.#####.#.#########.#
#.......#.#.#...#...#.#...#.....#.....#...#.#.#.#.#.#.#.#...#...#.......#...#.#.#
#.#.#####.#.#.#.#.###.#####.#######.#.#.#.#.#.#.#####.#.###.#.#.###.#.#.###.#.#.#
#.#.#.......#.#.#.........#...#.....#...#.#.#.#.....#.#.#.#.#.#.#...#.#...#.#...#
#########.#####.###.#####.#######.#.#.#.#####.###.#.#.#.#.###.#########.###.#.#.#
#.#.......#.#...#.#.....#.#.....#.#.#.#.........#.#.#...#.....................#.#
#.#####.###.###.#.#.#.#####.###.#.#####.###.#.#####.#############.#.###.###.#.#.#
#...#...#.#...#.#...#...#.#...#.#...#...#.#.#...#.......#.......#.#.#...#.#.#.#.#
#.#.#.###.#.#######.#####.#.###.#####.#.#.#.###.#.###.#########.#.###.#.#.#####.#
#.#...#.....#...#...#.#.#...#.#.#...#.#...#.#...#...#.#.#.........#...#.#...#.#.#
#.###.#.#####.#####.#.#.#####.#.###.###.#.#.#########.#.#.###.###.#.###.###.#.#.#
#...#.......#.........#...#.#...#.......#.#.#.............#...#.#.#.#.#...#.#...#
#.#####.###.#.#######.#.###.#.###.###.#####.#####.###.#.###.###.#.###.###.#.#####
#.#.#.....#.#.#.....#.#...#.........#.#.....#.#.#.#.#.#.#...#...#...#...#.......#
#.#.#.#####.###.###.###.###########.#######.#.#.#.#.###.###.#.###.#.#.#.#####.###
#.#.....#...#.#.#.....#.........#.....#.#.#.#...#.#.....#.#.#...#.#.#.#.#.......#
#.#.#####.###.#.###.###.###.###.#.###.#.#.#####.#######.#.#.#.###.#####.#.###.#.#
#.#...#.#.#.....#.#.#...#...#.......#.#...#...#...#.......#.#.....#.#.#.#.#.#.#.#
###.###.#.#.#####.#.#####.###############.#.###.#.#####.###.#.#.#.#.#.#.###.#.###
#...#.#...#.#.........#.#...#.......#...#.......#.#.#.#...#.#.#.#.#.#.#.......#.#
###.#.#####.###.#.###.#.###.###.#####.#.###.###.###.#.#.#####.#.###.#.#.###.###.#
#.....#...#.#.#.#.#...#...............#.#.....#.#.......#.#.#.#.#...#.....#.#...#
#####.###.#.#.#.###.#####.#####.#.#.###########.###.#.#.#.#.#.###.#.###.#######.#
#...........#.....#.#...#.#.#...#.#...#.......#.#...#.#.....#.#...#...#.#.......#
#.#.###.###.###.#####.#.#.#.#########.#.###.###.#####.#.###########.###.#.###.###
#.#.#.#...#.#.#.#.#...#.......#...#...#.#...........#.#.#...#...#.....#...#.....#
#.###.#####.#.###.#########.#.###.#.###.#####.#.###.###.#.#####.#.###.###.###.###
#...#.......#...#.#...#.....#...#.....#...#.#.#...#.......#.......#...#.....#...#
#.###.#####.###.#.#.###.#######.#####.#####.#####.###.###.#######.#.#####.#######
#.#.....#.....#...#.....#...#...#...#.#...#...#...#.....#.....#...#.#.........#.#
#######.###.#.#.###.#######.#####.###.###.#.#.#.###.#.#.#.#.#.#.#######.#.###.#.#
#.........#.#.#.....#...#.....#...#...#.....#.....#.#.#.#.#.#.#.......#.#...#...#
#####.#.#.#######.#####.#.#.#####.#.#####.###.#.#.###.#########.#####.#.#####.#.#
#.#...#.#.#.#...#.........#.#.....#...#...#...#.#.#.#...#...........#.#.....#.#.#
#.#######.#.#.###.#####.###.###.#####.#.#.#########.###.###.###.#.###.#.#########
#.#.#.................#...#.#.#.....#.#.#.#.#.......#...#.#.#...#.#.#.#.........#
#.#.#.###########.#######.#.#.#.#.#.#.#.#.#.###.#####.#.#.#.#.###.#.#.#.#########
#.....#.....#...........#.#.....#.#.#.#.#.#.....#.....#.#...#.#.#.#...#...#.#...#
#.###.###.###.#.#.#############.#.#####.###.#####.###.#.#.#.###.#######.###.#.###
#...#.#.#.....#.#.#...#.#...#...#...#...#.#...#.#.#...#...#.#...#.#.............#
#.###.#.#.###.#######.#.#.#########.###.#.#.#.#.#.#.#######.###.#.#.###.#######.#
#.#.#.#.....#.#.#.#.#.....#...........#.#.#.#.....#...#.#.#.....#.#...#.......#.#
#.#.#####.###.#.#.#.#.###.###.#.###.#.###.###.###.###.#.#.###.#.#.#############.#
#.#.....#.#.....#.....#.....#.#...#.#.#...#.#.#...#.......#...#.#.......#.#.#.#.#
#.#.#.#######.#.#.#####.#.#.#.###.#.#.###.#.###.#####.#.###.#.###.#######.#.#.#.#
#.#.#.........#.#.#...#.#.#.#.#.#.#.#.......#.....#.#.#...#.#...........#...#...#
#.#####.###.#.#.###.#.#.###.#.#.#.###.#########.###.#####.#.#.#####.###.#.#####.#
#.#.......#.#.#.....#.....#.#...#.#.........#...#.........#.#...#...#...#........
###############################################################################.E
