S.###################
..#...#.............#
#.#.#.#.###.###.###.#
#...#...#...#.#.#...#
#####.#.#####.#####.#
#.....#.#...#.......#
#.#.###.#.#.###.###.#
#.#...#.#.#...#.#.#.#
#.#.#.###.###.#.#.#.#
#.#.#.#.#.#.#...#...#
###.#.#.###.#.#####.#
#...#.....#.#.#.#...#
#####.#####.#.#.###.#
#.#.....#.........#.#
#.#.###########.###.#
#.......#.#...#...#.#
###.###.#.#.###.#####
#...#...#.#...#.....#
#.#######.###.#.###.#
#.#.............#....
###################.E
