S.#####################################
....#.......#.#.....#.........#.#.#...#
#.#.#####.#.#.###.#.#.#.###.###.#.#.###
#.#.#.....#...#...#...#.#.........#...#
#.#.#.###.#.#.#.#####.#.#####.#####.#.#
#.#.#.#...#.#...#.#.#.#...#.#...#...#.#
#.#.###.#####.###.#.###.###.#.#######.#
#.#.....#...#.#.#.......#.#.#...#.....#
#######.#.###.#.#########.#.#.###.#####
#...#.......#...#...#...#.#...#.#.#...#
#.###.#.###########.#.###.#.#.#.#.#.#.#
#.#.#.#.#.#.........#.......#.......#.#
#.#.###.#.#.#####.#.#.#####.#####.#.#.#
#.#.....#...#...#.#.......#.#.#.#.#.#.#
#.###.#####.#.#####.#.#.###.#.#.#.#.###
#.....#...#.#...#...#.#...#.#...#.#.#.#
#####.###.###.#.###.###########.#####.#
#...#.#.#.#...#.......#...#.#.........#
#.###.#.#.###.###.###.#.###.#####.#.#.#
#...#.#.#.....#...#...#...#...#...#.#.#
#.#####.#.###.#.#####.#.###.###.#####.#
#...#.....#.#.#.#.......#...#.....#.#.#
#.###.#####.#####.#.#####.###.#####.#.#
#.#.#.#.....#.#.#.#.................#.#
#.#.#.###.###.#.#############.#######.#
#.#.#.......#.#.#.#...............#...#
#.#.#.#####.#.#.#.###.###.#.###########
#...#.#.#.......#.......#.#.#...#.....#
###.#.#.#####.#.#######.#.#.#.#.#.#.###
#.....#.....#.#...#.....#.#...#.#.#...#
#####.#.#######.###########.#####.###.#
#.#.....#...........#.....#.....#.#...#
#.#.#.#####.###.#.#######.###.#.###.#.#
#.#.#.#...#.#.#.#...#...#...#.#.#.#.#.#
#.#.#####.###.#.#####.#.###.#.###.###.#
#...#.#...#.....#...#.#.#...#.#.#.....#
#.###.#.#.###.###.#.#.#.#.#.#.#.###.###
#...#...#.........#...#.#.#............
#####################################.E
