S.################################################
........#.#.....#...#.#.......#.....#............#
#.#.#####.###.#.#.###.###.#.#.#.#.#####.#.###.#.##
#.#.#.....#...#.#.........#.#.#.#.#.....#.#...#..#
#.#.#.#######.#.###.###.#.###.###.###.#####.######
#.#.......#.#.#.#...#...#.#.#.#.#...#.#..........#
#####.#.###.#.#########.#.#.#.#.###.#.#######.####
#.#...#.#.......#...#.#.#...#.#.........#...#.#..#
#.###.#####.#.#.###.#.#.#############.#####.######
#.#.........#.#.....#.#.....#.#...#.....#.#...#..#
#.###.#########.#.###.#.###.#.###.#.###.#.#.#.####
#.#.#...#.#.....#.#...#.#...#.#.......#.....#....#
#.#.#.###.#.###.#.###.#.#.###.#########.#.#.######
#.....#.#...#...#.......#.#...........#.#.#.....##
#.#.###.###.#########.###.###.#####.#####.#.#.####
#.#.#...#.#.#.....#...#.........#.....#...#.#....#
#.###.###.#.#.#############.#.#.#.###.###.#####.##
#.#...#.....#.....#.#.......#.#.#.#.#.#.#.#.#...##
#####.#.#.#####.###.###########.###.###.#.#.######
#...#...#...#...#...#...............#.#.#...#....#
###.#.#####.###.#.#.###.#.###.###.###.#.##########
#.....#...#.#.....#.#.#.#.#.#...#.......#.#.#.#..#
#.###.#.#####.#######.###.#.#######.###.#.#.#.#.##
#...#...#.#...#.#.........#.......#...#...#...#.##
#.#.###.#.###.#.#####.#.#.###.#####.#####.###.#.##
#.#.#.#...#...#...#...#.#...#...#.#.#.#.......#..#
#.###.#.###.###.#.#.#######.###.#.###.#.###.###.##
#.#.......#...#.#.#.#.......#...#.#...#...#.....##
###.###.#.#.###.#.#####.#.#####.#.#.#######.######
#.#.#...#.....#.#.#...#.#.#...#.#.#.......#...#..#
#.###.#######.#.#####.#.#.#.###.#.#.#.###.###.####
#...#.#.......#.#.....#.#...#.#...#.#...#...#....#
#.#.#.#.#.#.###.#.#.#.###.#.#.#.#.#.#.#####.#.####
#.#...#.#.#.#.#...#.#...#.#.#...#.#.#.#.......#..#
#######.#.###.#####.###.###.###.#####.#.#.###.#.##
#.......#.......#.#.#.#.#...#.#.#.....#.#.#...#..#
#.#######.###.###.#.#.###.###.#.#.###########.####
#...#...#.#.#...#.....#.#.....#.......#.#...#....#
###.#.###.#.#.###.#.#.#.#.#.###.#.#####.#.#####..#
#.#...#.#...#.#...#.#.....#.#...#.#..............#
#.#.###.#.#.###.#####.#######.#.#########.#.#.#..#
#.....#...#.#.#.#...#.#...#...#.#.........#.#.#..#
#.###.#######.###.###.#.#####.#.#.#.#####.#####..#
#.#.....#.#.........#.#...#...#.#.#...#.#.#......#
#.###.###.#.###.#######.#.#.#########.#.###.######
#.#.......#.#...#.#.....#.#.#.....#...#...#...#..#
#...#...#.#...#.....#.#...#.#.#...#.#.#.........##
#.#####.#.#####.#.###.###.#.#.###.#.###.###.#.#..#
#...#.......#...#...#.......#.#.........#...#.#...
################################################.E
