S.###########################################
....#...#...#.............#...#.............#
#.#.#.###.#.#.#########.###.#.###.#####.###.#
#.#.#.....#.#.....#.....#.#.#...#...#.#...#.#
#.#####.#.#.#.#########.#.#.#######.#.#####.#
#...#...#.#.#...#...#...#.#.....#.#.#.#...#.#
###.#.###.###.###.###.###.#.###.#.#.#.#.###.#
#.#.....#.#.........#.#.#.....#.#...#.......#
#.###.#.#####.###.#.###.###.#####.#.#######.#
#.#...#.......#.#.#.#.#.#...#.....#.#.....#.#
#.#.###.#.###.#.###.#.#.#.#####.#########.#.#
#.#...#.#.#.#.#.....#...#.#...#.#.#.....#...#
#.#########.#####.###.#.#.#.###.#.#.#.#.#.###
#...#.#...#.......#...#.#...#...#.#.#.#.#...#
###.#.###.#####.#######.###.###.#.#.#####.###
#.....................#.......#...#.........#
###.#.###.###########.#.#.###.#####.###.#####
#.#.#...#.#.#.....#.....#...#.....#.#.#...#.#
#.#########.#.#########.#.###.#####.#.#####.#
#.....#...#.#.....#.#.#.#...#.#.............#
###.#.#.###.#.###.#.#.#.###.#.#.#########.###
#...#...#.#...#.#.......#...#.#...#.#...#.#.#
#.#.###.#.#.#.#.#.###.#.#####.#.#.#.###.#.#.#
#.#...#.#.#.#.#.....#.#.....#.#.#.#...#.....#
###.#.#.#.###.#####.#######.#.###.###.###.#.#
#...#.#.....#.#.....#.#...#.#.#.....#...#.#.#
###.###.#####.#####.#.#.###.#####.#.#.#.#.#.#
#...#.#.......#.....#.#...#.#.....#.#.#...#.#
#.###.#####.#.###.###.###.#.#######.#.#.#####
#.#.....#...#...#...#.....#.#.#...#.#.#.#...#
#.#.###.#########.###.#.#.#.#.###.###.#####.#
#.....#.#.......#.#.#.#.#...#...#.#...#...#.#
#.#####.#######.###.#######.#.#.#.###.#.###.#
#...#...#.....#.#.#.....#.....#...#.........#
###.#####.###.#.#.#.#.#.#######.###.###.###.#
#.........#.#...#.#.#.#.#.#...........#.#...#
#.#.#####.#.###.#.#.#####.#.#####.#.#######.#
#.#.#.#.....#.#.#...#.....#.#...#.#.#.#.#...#
###.#.#.#####.#.#.#####.#.#.#.###.#.#.#.#.###
#.....#.#.#...#...#.#...#.#.....#.#.#.#.#...#
#.#######.#.#####.#.###.#########.#.#.#.#.###
#...#.......#.#.....#...........#.#.....#...#
###.###.#.#.#.###.#.#.#.###.###.#####.###.#.#
#...#...#.#.......#...#.#...#...#.......#.#..
###########################################.E
