S.######################################
..#...#.........#.#.#...#..............#
#.#.#####.###.#.#.#.#.###.#.###.#.######
#.#.#.......#.#.#.#...#.#.#.#...#...#..#
#.#.#.#.#.#.#####.#.#.#.#.###.###.####.#
#...#.#.#.#.........#.....#...#.#.#....#
#.###.#.#.#####.#.#.###.#.###.#.###.####
#...#.#.#.#.....#.#.#.#.#...#.#........#
#.#####.#####.#######.#.###########.##.#
#.....#.#.............#.....#.......#..#
#.#####.#####.###.#######.#####.###.##.#
#.#.....#.....#...#.#...#.#...#...#.#..#
#.#####.#########.#.###.#.###.#.########
#.#.............#...#.........#........#
#.#######.#######.#######.#.###.#.#.##.#
#...........#...#...#...#.#.....#.#.#..#
#.###.#.###.#.#######.#####.#.#.#.####.#
#...#.#...#.#...#...#...#.#.#.#.#...#..#
###.###.###.#.#####.#.###.#.#####.####.#
#.....#...#.#.....#...#...#.#...#.#....#
#######.###.#.#.#.#.#.#.#.#.#.#.######.#
#.......#.#.#.#.#...#.#.#.#...#.....#..#
#.###.###.#.#######.#####.#####.#.######
#.#...#.#.#.....#...#.#.........#...#..#
####.##.#.#########.#.#.#############.##
#.#.........#...#...#.#.#.....#........#
#.#.###.###.#.###.#.#.###.#.#####.####.#
#...#.#...#.#...#.#.....#.#.......#.#..#
#.###.#.#####.###.###.###.###.#####.####
#.....#.........#...#.#...#.#.....#.#..#
###.#######.#.#.#.#########.#.#####.##.#
#.....#.....#.#.#.......#...#.#.#.#....#
#.###.#.#####.#.###.###.#.#.#.#.#.#.####
#...#.#...#...#...#...#...#...#.#......#
###.#####.#.#######.#######.#.#.########
#.#...#...#.#.......#.....#.#.#........#
#.#.###.#.#.#.###.###.#.#.#.#.#.#.###..#
#.#.#.#.#.###.#.#.#.#.#.#.#.#.#.#.#.#..#
#...#...#.....#...#...#.#...#...#.#.....
######################################.E
