S.#############################
............#.....#.#.#.......#
#####.#.#.#######.#.#.#.#####.#
#.....#.#.#...#.#.......#.#.#.#
###.#.###.#.###.#####.###.#.#.#
#...#.#.......#.........#...#.#
#########.#####.#.###.###.#.###
#.#.........#.#.#.#.......#.#.#
#.#.###.#.###.###.###.#.#####.#
#...#...#...#...#...#.#...#...#
###.###.#.#####.###.#.#######.#
#...#.#.#.#.......#.#.....#.#.#
###.#.#.#####.###.#.###.#.#.#.#
#...#.........#.......#.#.#.#.#
###########.#.#####.#######.#.#
#.....#...#.#...#...........#.#
#.#####.#.#.#####.#.#.#####.#.#
#.#...#.#...#.#.#.#.#.#.......#
#.#.#######.#.#.#######.###.#.#
#.........#.........#...#...#.#
#.#######.#.###.###.#.###.#####
#.#.......#.#.....#.#.#.....#.#
#.###.###.#.#########.#######.#
#...#.#.#.#.#.#...............#
#.#.#.#.#.#.#.###.###.#####.###
#.#.#...#.#...#.#...#...#.....#
#.###.###.###.#.###.#######.#.#
#...#.#.......#.........#...#.#
#####.###.###.#####.#.#####.#.#
#.....#...#...#.....#...#...#..
#############################.E
