S.#####################################################
............#.#.....#.#.#.........#...#.....#...#.#...#
#.###.#######.#.#####.#.###.###.#.###.#.#.#.#.###.#.###
#.#...#.....#.....#.....#.#.#.#.#.....#.#.#...#...#...#
###.###.#####.###.#.#####.#.#.#######.#####.###.###.###
#.#.....#.#.#.#...#.#.#.....#.....#...#.......#.......#
#.###.#.#.#.###.###.#.#.#########.#.#.#######.#####.###
#.....#...#.#.............#.....#...#.....#.#...#.#...#
#.###.#.#.#.#.#.#.###.#####.###.#.#########.#.#.#.#.#.#
#.#...#.#.....#.#.#.#...#...#.......#...#.#...#.....#.#
#.###.#####.#####.#.###.#.###.#####.###.#.#.#.###.###.#
#.#...#.#.#...#...#...#.#...#.#...........#.#...#...#.#
#.#####.#.#######.###.###.#######.#.#####.#.###.#.#####
#.#.......#.......#.........#.....#.#.#.#.#.#...#...#.#
#.###.###########.###########.#.#####.#.#######.###.#.#
#...#...#...#.#...#.#...#...#.#...#.....#.#.....#...#.#
#####.#.###.#.#.###.#.###.#.#####.###.###.#.#.###.#.#.#
#.#...#.#...#.............#.....#.........#.#...#.#...#
#.#.#.###.###########.###########.###.###.#.###.#####.#
#.#.#.#.#...#.....#...#.....#...#...#...#.#...#.....#.#
#.###.#.#.###.#####.###.#.#.#.#.###.#.###.#.###.#####.#
#.......#.......#...#...#.#.#.#...#.#.#.#.#.#...#...#.#
#######.###.#.#######.#.###.#.###.###.#.###.#####.#.#.#
#...#.#.....#...#.#...#...#...#.#.#.#.......#...#.#...#
#.###.#.#####.###.#.###.#######.###.#.#.#.#.###.###.###
#...#.......#.#.....#.....#...#...#...#.#.#.#...#.....#
#.#.#######.#######.###.#.###.#.#######.###.#.#.#####.#
#.#.....#.......#...#.#.#.#.#.......#.#...#.#.#...#.#.#
###.#.###.#.#####.###.#.###.#.#####.#.###.#.#.#####.###
#...#...#.#.....#.....#.#.#.....#.#...#.#.#.......#.#.#
#.#####.###.#.#.###.#.###.#######.#.###.#####.#.###.#.#
#...#.#.....#.#...#.#.#.....#.#.........#...#.#.......#
#####.###.#####.#.#.#####.###.#########.#.#.#####.#.#.#
#...#.#.#...#.#.#.....#.....#.........#...#.#...#.#.#.#
#.###.#.#.#.#.#.###.#.#.#####.#######.###.#####.#.###.#
#.#.......#...#...#.#.#...#.......#...#.#...#...#.#.#.#
#.###.#####.###.#.###.###.#####.###.#.#.#.#.#.#.#.#.###
#.#.#.....#.#.#.#.#.#.#.#.......#...#.....#...#...#...#
#.#.#.###.###.#####.#.#.#####.#####.###.#.#####.#.#.###
#.....#.........#...#...#.#.#.#.......#.#...#...#.....#
#.###.#.###.#.###.#.#.#.#.#.#####.#.#.#.#######.#.#####
#.#...#.#...#...#.#...#.....#.....#.#.#.#.....#.#.#.#.#
#.###.###.#.###########.#####.#####.###.#.#.###.#.#.#.#
#.#.....#.#...#.#.......#...#...#...#.#...#.#...#.....#
#.#.###.#####.#.#####.###.#.#.#.###.#.#.#.#.#######.#.#
#.#.#...#.......#...#.....#.#.#...#.#...#.#.....#.#.#.#
#.###.#############.#####.#.#####.###.#.#####.###.###.#
#.#.#...#.#.........#.....#.#...#.#.#.#.....#...#.#.#.#
#.#.#####.#######.###.#####.#.#####.#########.###.#.#.#
#.......#...#.......#.....#.#.#.#.........#...#.....#.#
#.#####.###.#####.#########.#.#.#####.#######.#####.#.#
#.....#.........#.......#.#.............#.#.#.....#...#
#.###.###.#.#####.#####.#.#.###.#.###.#.#.#.###.###.#.#
#.#.....#.#.#.....#.........#...#...#.#.........#...#..
#####################################################.E
